0000000000000
0010000000000
0000001000100
0000000000000
0000000000000
0100000000000
0000001000000
0000000000100
0000000000000
0001000000000
0000000000000
0000000100001
0000000000000

2172716504
