000000000
188753186
000010001
188753186
000000000
188753186
000000000
188753186
001000010
188753186
000000000
188753186
000000000
188753186
010001000
188753186
000000000
188753186
